1.g.g.g.g.g.g.g.g.2
#################.g
.rrrrrrr#.g.g.g.g..
.################.g
....#r.......r#....
........###.......g
#######...#.#######
r.......#r#.......r
#######.#...#######
g.......###........
....#r.......r#....
g.################.
..g.g.g.g.#rrrrrrr.
g.#################
4.g.g.g.g.g.g.g.g.3